25;pink;
#########################
#########################
#########################
###....#.........#....###
###*##.#.#######.#.##*###
###...................###
####.#.####.#.####.#.####
####.#.####.#.####.#.####
OOOO.#......#......#.OOOO
####.###O#######O###.####
####.OOOOOOOFOOOOOOO.####
####.###O###O###O###.####
####.#OOO##FFF##OOO#.####
####.#O#O#######O#O#.####
OOOO.OO#OOOOOOOOO#OO.OOOO
####.######O#O######.####
####......OO#OO......####
####.####.#####.####.####
###.........P.........###
###.###.###.#.###.###.###
###.###.#...#...#.###.###
###*###.#.#####.#.###*###
###...................###
#########################
#########################
